tilemap-1.png 128 7 7
0 1 1 2 3 4 0
1 0 1 0 1 1 1
0 1 2 3 4 5 0
1 1 0 1 0 1 0
2 0 1 1 2 1 1
3 1 0 1 0 1 1
4 0 1 1 0 5 6
